 __________ 
|J_________|
|__________|
|__________|
|__________|
|__________|
|__________|
|__________|
|__________|
|__________|
